64

3
-24 33 30

10
37 43 28 -15 16 -26 28 64 62 26

9
11 -44 6 -14 -58 -7 19 -43 -45

2
-49 -20

6
-19 -36 -12 36 -25 -56

8
-5 -21 -7 63 -14 17 -16 9

7
-47 64 32 -8 -33 17 -61

10
-61 10 35 40 39 -14 58 25 5 5

6
-16 -47 60 -8 -42 -53

7
56 -53 58 24 -17 -29 -22

1
27

6
42 -16 -14 -33 56 -59

1
50

1
17

7
-40 -18 7 14 -48 29 -17

5
-41 47 -2 13 6

6
-49 62 -36 -63 -29 47

8
30 -8 33 14 -50 18 -34 46

3
26 -63 -43

4
42 -24 -5 -26

2
-34 -49

9
-57 24 58 -40 -32 -1 1 -33 18

2
41 60

9
-29 -50 41 -8 16 -43 24 48 -20

6
20 -12 24 -45 -12 -41

3
-34 48 22

7
-38 22 -45 -30 -59 14 20

10
-43 48 -58 20 28 -35 62 -2 -30 -62

4
-36 -37 54 -44

3
46 57 -30

8
49 -16 -42 -35 28 -63 -8 53

5
26 -40 52 23 -35

3
1 -49 -7

10
48 56 -54 15 9 28 -10 -59 -64 32

10
-3 -12 -37 51 -60 27 -63 -10 58 -8

1
-59

2
-53 1

9
22 -44 60 30 -32 -50 35 -38 -16

6
1 -23 -39 13 58 -62

9
-46 28 -59 31 2 -1 23 -48 12

62
7928 3410 -3563 -5658 8683 -9174 -3684 -2105 717 2138 -3731 3831 9920 -5829 7608 219 757 -8830 2827 -8947 -5869 -6994 9371 475 2619 7662 -3806 5394 -1249 1458 2864 -743 4361 643 -410 5047 414 8533 7489 -6223 -7971 2807 1728 4556 5774 8183 -394 8608 4849 -8292 -1544 4240 -1730 -4444 8131 -2029 -902 -6932 -9387 1956 3853 -6500

46
5107 -6616 -9994 4956 -8818 7764 7708 6072 1714 -5627 1808 8638 -211 -7147 -3000 8468 -9446 1519 -6013 -5474 6090 -9123 -9274 -4874 -71 -6591 5108 1525 8081 -8371 2767 1890 8273 -8003 6235 5467 9416 8825 2488 2380 550 7139 -6902 -7327 3686 -2413

4
4303 -3511 -3017 6649

44
5324 6907 3653 7846 8303 -7706 404 -456 5940 -6130 3296 -9006 -4877 4031 6068 -8638 1838 5539 1290 7873 4483 7737 6536 -1671 -5037 7179 -9166 9347 -1956 -9418 -251 -5766 6303 -3929 7392 9887 3731 5815 -2168 -2741 5284 -8240 2455 1196

62
-613 7565 902 -1322 9933 -2301 5151 -8169 2693 -7645 7527 -1813 9440 2604 161 -4340 2148 8497 -4260 7958 -1434 -8630 3489 2062 -1584 2710 -7258 -2908 9840 -75 -5227 3478 9021 3127 -8143 3825 4046 2511 5604 67 -630 2649 -3650 936 3770 9842 4479 -2722 1644 6780 3283 9361 -5761 -1214 9147 4903 408 -4014 -5811 250 5015 -8576

94
-1297 -4108 6124 -6778 -9605 8839 1672 -6974 -7809 -9710 -3466 -7521 -3072 -6134 -2028 -1979 4971 -6819 6331 6876 406 115 -8620 1379 2892 -8139 -3911 -1124 9111 -9200 9235 -813 -9969 -8002 -3931 -4938 3294 6412 4843 4693 5230 -443 1194 8826 1526 -7794 5555 7668 -8941 -4526 -3249 -9910 867 -4807 -462 6147 5034 -3887 -858 2883 -7089 9494 -1985 -7222 -5533 -2851 -1209 1674 -5432 -488 8684 641 -9574 -6296 -3591 2813 -2557 2377 -8522 4522 1344 5538 -132 -7331 -6395 4160 803 8795 5679 7158 -6971 9003 -4979 -6771

100
-7644 -5024 9442 1499 -1259 -9399 3925 -9879 9623 754 3764 4386 -1728 5064 -3386 -6787 8820 2397 -5738 -7617 3659 2423 -4196 -2659 8907 7585 2490 2754 -4937 -3675 9084 -5703 -2271 -5219 4697 1355 2555 -5938 2430 6919 1064 -357 -9176 4121 3631 8785 4608 3320 1642 7589 -7725 -4694 -9072 -9732 -8283 9188 3856 9250 -5357 3494 -7517 -8052 -5822 -1706 -6261 -3801 -4589 6968 1829 -7864 -6053 -5808 9298 -9291 -4778 3641 -7766 -771 -5767 7402 -8122 8716 -2400 -9074 5085 7042 -6692 -7397 4257 -6996 2174 7680 5032 9878 -3630 -5529 -1185 7165 8982 -4163

19
7556 -8923 5303 1012 -8259 -515 -4077 6630 3035 8859 5661 7850 478 -1590 8299 1651 9914 2609 -8189

20
-6448 423 444 1027 263 -4532 3171 -1129 8323 -7367 3563 5745 9288 8376 858 -764 -4714 -8054 4766 -831

80
-1714 -6113 -2139 4233 -5609 965 422 6973 -1459 301 -4944 -871 4715 3599 -9562 -9441 -5989 -833 3794 -1882 9743 -7088 2282 3255 -8240 -6249 -215 -8368 -2202 1427 -3296 -3038 -2771 116 -5287 -8670 -1195 -1544 -2521 9921 1056 -6646 -2344 -2551 -3330 2660 4844 -8614 -2270 -6883 7077 5288 4013 4452 -7981 3644 -9596 -6659 -8005 -2836 9538 -663 3895 4700 8004 72 -3485 -9704 -2190 -381 -1230 1911 -7016 -9116 4129 -9058 -6501 752 -5348 -6558

3
6629 -6868 7190

65
-7696 -3403 -5121 -2454 233 -6212 6223 -4380 -7692 -9469 -6933 9094 9007 7183 3770 -4226 -2644 -3094 9293 -2603 9819 239 -6786 1467 2452 -7516 3312 -9699 9541 -2367 4780 -1126 -573 -1538 -2469 5742 -5658 4679 -9653 -6920 3431 1487 -3748 -1764 770 -2949 -7075 -9323 -7349 215 4055 -8456 992 -2155 -1983 2748 2565 -8508 -4475 -2304 753 -7144 -2031 8177 -29

92
4084 4004 -8043 8653 -1824 -1435 -6643 -2096 -2847 -1611 -5823 -1586 5245 4530 -4432 -2875 -6324 5014 -6719 3053 7744 -2131 -9211 6397 5648 -148 -7573 -7824 -6136 -144 1626 1786 -6247 -2315 -6817 4210 2558 8002 -6918 -3826 -8757 -387 8409 5498 -6915 -7816 1362 -9192 5456 -3276 9578 9535 -177 -255 8287 2363 -756 -3372 -3663 61 -3566 8172 180 -5239 -5221 -4258 2352 -3285 4033 -8678 -3971 9361 6492 -3890 658 3434 -4529 -5502 -5320 -3047 5607 -8042 153 9541 -7568 6503 5609 -2616 -1299 -4958 9511 8883

39
4384 -8019 850 -3434 9304 -1010 -3636 900 -1696 3814 7757 7913 -3575 6475 5102 1018 4668 7313 -6650 -6374 -1193 -9285 2576 -3033 -5326 885 1815 -6398 -1368 -59 6090 8659 -2815 -6274 -9421 -1769 6382 1793 -3942

25
9267 9520 2540 1449 -6035 -4339 6762 7514 -932 -144 9257 8517 1875 8015 6215 -5819 -3565 532 5 6736 -2653 7599 5543 3284 -7652

27
6909 -4442 795 -7496 2929 -3796 -251 -1644 5489 9442 8980 -1830 -8762 -4381 945 -7513 -6727 -3686 5021 1851 7868 -9062 7483 3527 3385 3555 2539

36
1300 7840 -2324 -6751 5077 -2918 6430 -7153 -8318 -6144 -9337 -2665 2937 -8566 4523 -5112 1681 -7764 7653 9588 5923 -4383 6603 -9434 3389 -410 8778 7737 1410 -3366 2955 -809 -483 1343 9438 7217

12
7951 -6388 9848 -9226 772 -553 -6040 -7959 8336 1648 7403 -3646

26
-8133 -1258 -9826 -9652 7430 -6439 1066 -8563 -8767 -9056 -3069 -5720 -9396 -7065 5233 2358 -7505 -1418 1009 -274 9261 2581 4926 -9694 -6254 -7429

22
-9501 8597 -2400 6319 9336 5646 3805 -311 -9600 485 4033 7589 -6856 -7780 5062 4805 2437 -5648 -6730 -2978 -706 -1719

10
-8381 6605 8922 3864 -6856 -2938 -9522 9550 -6050 -1764

2
2952 -7132

81
7837 -9370 4259 783 -3933 130 -2139 9539 7826 2673 -4739 541 875 5805 6486 -7409 1691 3020 -7231 6812 -6210 -5311 6630 -2479 -6613 4533 -225 -4204 779 3561 4444 -1585 450 8434 1110 -5194 -1242 -8370 -1705 5030 -2351 6019 7339 27 -2933 -5380 3611 6213 4272 -4443 -8947 5403 140 763 -971 6513 1705 2249 -1809 -7159 4917 4821 -5854 8938 -4736 1857 9367 -6574 -7382 7703 9479 -4377 -9450 -226 -1603 2352 -2626 1397 -909 4955 6417

63
5784 -8603 4154 2992 -1768 3234 3008 9527 7813 -2969 -2240 2080 3753 -8376 1534 4129 -8310 -2606 -5020 -1319 -5506 6089 -762 -9130 1581 5608 1294 -7241 2804 3497 -7153 1653 356 7924 2558 -4866 -146 2928 -9273 -2184 -3211 1025 1830 -2253 -233 -5321 -3374 -9199 3934 1809 -9068 7258 3980 -6472 1297 6808 -2799 5362 8801 5613 -3363 -2769 610
